10,10
00,01,03,03,03,03,02,03,01,04
05,06,11,11,11,11,11,11,11,09
05,11,11,11,11,11,07,11,11,09
05,11,11,07,07,07,11,11,11,09
05,11,11,07,11,07,11,11,11,09
05,11,11,07,07,07,11,11,11,09
05,11,11,11,11,11,11,11,11,09
05,11,08,11,11,11,12,11,11,09
05,11,11,11,11,11,11,11,13,09
15,18,18,18,17,18,18,16,18,19